20;20;20;20;20;20;20;20;20;20;20;20;20;20;20;20;20;20;20;20;20;20;20;20;20;20;20;20;20;20;20;20;20;20;20;20;20;20;20;20;20;20;20;20;20;20;20;20;20;20;20;20;20;20;20;20;20;20;20;20;20;19;19;19;20;20;20;20;20;20;20;20;20;20;20;20;20;20;20;20;20;20;20;20;20;20;20;20;20;20;20;20;20;20;20;20;20;20;20;20;20;20;20;20;20;20;20;20;20;20;20;20;20;20;20;20;20;20;20;20;20;20;20;20;20;20;20;20;20;20;20;20;20;20;20;20;20;20;20;20;20;20;20;20;20;20;20;20;20;20;20;20;20;20;20;20;20;20;20;20;20;20;20;20;20;20;20;20;20;20;20;20;20;20;20;20;20;20;20;20;20;20;20;20;20;20;20;20;20;20;20;20;20;20;20;20;20;20;20;20;20;20;20;20;20;20;20;20;20;20;20;20;3
20;20;20;20;20;20;20;20;20;20;20;20;20;20;20;20;20;20;20;20;20;20;20;20;20;20;20;20;20;20;20;20;20;20;20;20;20;20;20;20;20;20;20;20;20;20;20;20;20;20;20;20;20;20;20;20;20;20;20;20;12;13;13;13;14;20;20;20;20;20;20;20;20;20;20;20;20;20;20;20;20;20;20;20;20;20;20;20;20;20;20;20;20;20;20;20;20;20;19;20;20;20;20;20;20;20;20;20;20;20;20;20;20;20;20;20;20;20;20;20;20;20;20;20;20;20;20;20;20;20;20;20;20;20;20;20;20;20;20;20;20;20;20;20;20;20;20;20;20;20;20;20;20;20;20;20;20;20;20;20;20;20;20;20;20;20;20;20;20;20;20;20;20;20;20;20;20;20;20;20;20;20;20;20;20;20;20;20;20;20;20;20;20;20;20;20;20;20;20;20;20;20;20;20;20;20;20;20;20;20;20;20;7
2;20;20;20;20;20;20;20;20;20;20;20;20;20;20;20;20;20;20;20;20;20;20;20;20;20;20;20;20;20;20;20;20;20;20;20;20;20;20;20;20;20;20;20;20;20;20;20;20;20;20;20;20;20;20;20;20;20;20;20;20;20;20;20;20;20;20;20;20;20;20;20;20;20;20;20;20;20;20;20;20;20;20;20;20;20;20;20;20;20;20;20;20;20;20;20;20;12;13;14;20;20;20;20;20;20;12;13;13;13;13;13;13;14;20;20;20;20;20;20;20;20;20;20;20;20;20;20;20;20;20;20;20;20;20;20;20;20;20;20;20;0;2;20;20;20;20;20;20;20;20;20;20;20;20;20;20;20;20;20;20;20;20;20;20;20;20;20;20;20;20;20;20;20;20;20;20;20;20;20;20;20;20;20;20;20;20;20;20;20;20;20;20;20;20;20;20;20;20;20;20;20;20;20;20;20;20;20;20;20;20;20;7
6;20;20;20;20;20;20;20;20;20;20;20;20;20;20;20;20;20;20;20;20;20;20;20;20;20;19;19;20;20;20;19;19;19;20;20;20;20;20;20;20;20;20;20;20;20;20;20;20;20;20;20;20;20;20;20;20;20;20;20;20;20;20;20;20;20;20;20;20;20;20;20;20;20;20;20;20;20;20;20;20;20;20;20;20;20;20;20;20;20;20;19;19;19;19;20;20;20;20;20;20;20;20;20;20;20;20;20;20;20;20;20;20;20;20;20;20;20;20;20;20;20;20;20;20;20;20;20;20;20;20;20;20;20;20;20;20;20;20;20;20;4;6;20;20;20;20;20;20;20;20;20;20;20;20;20;20;20;20;20;20;20;20;20;12;1;14;20;20;20;20;20;20;20;20;20;20;20;20;20;20;20;20;20;20;20;20;20;20;20;20;20;20;20;20;20;20;20;20;20;20;20;20;20;20;20;20;20;20;20;20;20;7
6;20;20;20;20;20;20;20;20;20;20;20;20;20;20;20;20;20;20;20;20;20;20;20;20;20;12;14;20;20;20;12;13;14;20;20;20;20;20;20;20;20;20;20;20;20;20;20;20;20;20;20;20;20;20;19;20;20;20;20;20;20;20;20;20;20;20;20;20;20;20;20;20;20;20;20;20;20;20;20;20;20;20;20;20;20;20;20;20;20;12;13;13;13;13;14;20;20;20;20;20;20;19;19;19;20;20;20;20;20;20;20;20;20;20;20;20;20;20;20;20;20;20;20;20;20;20;20;20;20;20;20;20;20;19;19;19;20;20;20;20;4;6;20;20;20;20;20;20;20;20;20;20;20;20;20;20;20;20;20;20;20;20;20;20;11;20;20;20;20;20;15;20;19;19;19;19;19;19;19;19;51;20;15;20;20;20;20;20;20;20;20;20;20;20;20;20;20;20;20;20;20;20;20;20;20;20;20;20;20;20;20;7
6;20;20;20;20;20;20;20;20;20;20;20;20;20;20;20;20;20;20;20;20;20;20;20;20;20;20;20;20;20;20;20;20;20;20;20;20;20;20;20;20;20;20;20;19;19;20;20;20;20;20;20;20;20;20;20;20;20;20;20;20;20;20;20;20;20;20;20;20;20;20;20;20;20;20;20;20;20;20;20;20;20;20;20;20;20;20;20;20;20;20;20;20;20;20;20;20;20;20;20;20;20;20;20;20;20;20;20;20;20;20;20;20;20;20;20;20;20;20;20;20;20;20;20;20;20;20;20;20;20;20;20;20;0;1;1;1;2;20;20;20;4;6;20;20;20;20;19;20;20;20;20;20;20;20;20;20;20;20;19;20;20;20;20;20;20;20;20;20;20;20;20;12;13;13;13;13;13;13;13;13;13;14;20;20;20;20;20;20;20;20;20;20;20;20;20;20;20;20;20;20;20;20;20;20;20;20;20;20;20;20;20;7
6;20;20;20;20;20;20;20;20;20;20;20;20;20;20;20;20;20;20;20;20;19;19;19;20;20;20;20;20;20;20;20;20;20;20;20;20;20;20;20;20;20;20;20;0;2;20;20;20;20;20;20;20;20;20;15;20;20;19;19;19;19;19;19;19;19;50;20;12;14;20;20;19;19;20;20;20;20;20;20;20;20;20;20;20;20;20;20;20;20;20;20;20;20;20;20;20;20;20;20;20;20;20;20;20;20;20;20;20;20;20;20;20;20;20;20;20;20;20;20;20;20;20;20;20;20;20;20;20;20;20;20;20;4;5;5;5;6;20;20;20;4;6;20;20;20;12;1;14;20;20;20;20;20;20;20;20;20;12;1;14;20;20;20;20;20;20;20;20;20;20;20;20;20;20;20;20;20;20;20;20;20;20;20;20;20;20;20;20;19;19;19;20;20;20;20;20;20;20;20;20;20;15;20;19;19;19;19;19;19;50;20;7
6;20;20;20;20;20;20;20;20;20;20;20;20;20;20;20;20;20;20;20;20;12;13;14;20;20;20;20;20;20;20;20;20;20;20;20;20;19;19;19;20;20;20;20;4;6;20;20;20;20;20;20;20;20;20;20;12;13;13;13;13;13;13;13;13;13;13;14;20;20;20;20;0;2;20;20;20;20;20;20;20;20;20;12;1;1;1;14;20;20;20;20;20;20;20;20;20;20;20;20;20;20;20;20;20;20;20;20;20;20;20;20;20;20;20;20;20;20;20;20;20;20;20;20;20;20;20;20;20;20;20;20;20;4;5;5;5;6;20;20;20;4;6;20;20;20;20;11;20;20;20;20;20;20;20;20;20;20;20;11;20;20;20;20;20;20;20;20;20;20;20;20;20;20;20;20;20;20;20;20;20;20;20;20;20;20;20;20;20;0;1;2;20;20;20;20;20;20;20;20;20;20;20;12;13;13;13;13;13;13;13;14;7
6;20;20;20;20;20;20;20;20;20;20;20;20;20;20;20;20;20;20;20;20;20;20;20;20;20;20;20;20;20;20;20;20;20;20;20;20;12;13;14;20;20;20;20;4;6;20;20;20;20;20;20;20;20;20;20;20;20;20;20;20;20;20;20;20;20;20;20;20;20;20;20;8;9;20;20;20;20;20;20;20;20;20;20;8;9;10;20;20;20;20;20;19;19;19;20;20;20;20;20;20;20;20;20;15;20;19;19;19;19;19;19;19;50;20;15;20;20;20;20;20;20;20;20;20;20;19;19;19;20;20;20;20;20;8;5;10;20;20;20;20;4;6;20;20;20;20;20;20;20;20;20;20;19;20;20;20;20;20;20;20;20;20;20;20;20;20;20;20;20;20;20;20;20;20;20;20;20;20;20;20;20;20;20;20;20;20;20;20;4;5;6;20;20;20;20;20;20;20;20;20;20;20;20;20;20;20;20;20;20;20;20;7
6;20;20;20;20;20;20;20;20;20;20;20;20;20;20;20;20;20;20;20;20;20;20;20;20;20;20;20;20;19;19;19;20;20;20;20;20;20;20;20;20;20;20;20;8;10;20;20;20;20;19;19;19;20;20;20;20;20;20;20;20;20;19;20;20;20;20;20;20;20;20;20;20;20;20;20;20;20;20;20;20;20;20;20;20;20;20;20;20;20;20;20;12;13;14;20;20;20;20;20;20;20;20;20;20;12;13;13;13;13;13;13;13;13;13;20;20;20;20;0;2;20;20;20;20;0;1;1;1;2;20;20;20;20;20;11;20;20;20;20;20;4;6;20;20;20;20;20;20;20;20;20;12;13;14;20;20;20;20;20;20;20;20;20;20;20;20;20;20;20;20;20;20;20;20;20;20;20;20;20;20;20;20;20;20;20;20;20;20;8;9;10;20;20;20;20;20;20;20;20;20;20;20;20;20;20;20;20;20;20;20;20;7
6;20;20;20;20;20;20;20;20;20;20;20;0;2;20;20;20;20;20;20;20;20;20;20;20;20;20;20;20;12;13;14;20;20;20;20;20;20;20;20;20;20;20;20;20;20;20;20;20;20;12;13;14;20;20;20;20;20;20;20;20;20;20;20;20;20;20;20;20;20;20;20;20;20;20;20;20;20;20;20;19;19;20;20;20;20;20;20;20;20;20;20;20;20;20;20;20;20;20;20;20;20;20;20;20;20;20;20;20;20;20;20;20;20;20;20;20;20;20;4;6;20;20;20;20;4;5;5;5;6;20;20;20;20;20;20;20;20;20;20;20;4;6;20;20;20;20;20;20;20;20;20;20;20;20;20;20;20;20;20;20;20;20;20;20;20;20;20;20;20;20;20;20;20;20;20;20;20;20;20;20;20;20;19;19;19;20;20;20;20;20;20;20;20;20;20;20;20;20;20;20;20;20;20;20;20;20;20;20;20;20;20;7
6;20;20;20;20;20;20;20;20;20;20;20;4;6;20;20;20;20;20;20;20;20;20;20;20;20;20;20;20;20;20;20;20;20;20;20;20;20;20;20;20;20;20;20;20;20;20;20;20;20;20;20;20;20;20;20;20;20;20;20;20;20;20;20;20;20;20;20;20;20;20;20;20;20;20;20;20;20;20;20;0;2;20;20;20;20;20;20;20;20;20;20;20;20;20;20;20;20;20;20;20;20;20;20;20;20;20;20;20;20;20;20;20;20;20;20;20;19;20;4;6;20;20;20;20;4;5;5;5;6;20;20;20;20;20;20;20;20;20;20;20;4;6;20;20;20;20;20;20;20;20;20;20;20;20;20;20;20;20;20;20;20;20;20;20;20;20;20;19;20;20;20;20;20;20;20;20;20;20;20;20;20;20;0;1;2;20;20;20;20;20;20;20;20;20;20;0;2;20;20;20;20;20;20;20;20;20;20;20;20;20;20;7
6;20;20;20;20;20;20;20;20;20;20;20;4;6;20;20;20;0;2;20;20;20;20;20;20;20;20;20;20;20;20;20;20;20;20;20;20;20;20;20;20;20;20;20;20;20;20;20;20;20;20;20;20;20;20;20;20;20;20;20;20;20;15;20;20;20;20;20;20;20;20;20;20;20;20;20;20;20;20;20;8;10;20;20;20;20;20;20;20;20;20;20;20;20;20;20;20;20;20;20;20;20;20;20;20;20;20;20;20;20;20;20;20;20;20;20;20;15;20;4;6;20;20;20;20;20;8;5;10;20;20;20;20;20;20;20;20;20;20;20;20;4;6;20;20;20;20;20;20;20;20;20;20;20;20;20;20;20;20;20;20;20;20;20;20;20;20;12;1;14;20;20;20;20;20;20;20;20;20;20;20;20;20;8;9;10;20;20;20;20;20;20;20;20;20;20;4;6;20;20;20;20;20;20;20;20;20;20;20;20;20;20;7
6;20;20;20;19;19;19;20;20;20;20;20;4;6;20;20;20;4;6;20;20;20;20;20;20;20;20;20;20;20;20;20;20;20;20;20;20;20;20;20;20;20;20;20;20;20;20;20;20;20;20;20;20;20;20;20;20;20;20;20;20;20;20;20;20;20;20;20;20;20;20;20;20;20;20;20;20;20;20;20;20;20;20;20;20;20;20;20;20;20;20;20;20;20;20;20;20;20;20;20;20;20;20;20;20;20;20;20;20;20;20;20;20;20;20;20;20;20;20;4;6;20;20;20;20;20;20;11;20;20;20;20;20;20;20;20;20;20;20;20;20;4;6;20;20;20;20;20;20;20;20;20;20;20;20;20;20;20;20;20;20;20;20;20;20;20;20;20;11;20;20;20;20;20;20;20;20;20;20;20;20;20;20;20;20;20;20;20;20;20;20;20;20;20;20;20;4;6;20;20;20;20;20;20;20;20;20;20;20;20;20;20;7
6;20;20;20;20;20;20;20;20;20;20;20;4;6;20;20;20;4;6;20;20;20;0;2;20;20;20;15;19;19;19;19;19;20;20;20;50;20;20;20;20;15;20;20;19;19;20;20;15;20;20;20;20;51;19;19;19;19;19;15;20;20;20;20;20;15;20;20;20;19;19;19;19;19;19;51;20;15;20;20;20;20;20;20;15;20;20;19;19;19;19;19;19;19;19;19;19;19;19;19;50;20;15;15;20;20;20;20;20;20;19;19;19;19;19;20;20;20;20;4;6;20;20;20;20;20;20;20;20;20;15;20;19;19;19;19;19;19;19;50;20;4;6;20;19;19;19;19;19;19;19;19;51;20;15;20;20;20;19;19;19;19;20;20;20;20;20;20;20;20;20;20;20;20;20;19;19;19;19;19;20;20;20;20;20;20;20;20;20;20;20;20;20;20;20;20;4;6;20;20;20;20;19;19;19;20;20;20;20;20;20;20;11
6;1;1;1;1;1;1;2;16;16;16;16;8;10;16;16;16;4;6;16;16;16;4;6;16;16;16;0;1;1;1;1;1;1;1;1;1;1;1;1;1;2;16;16;0;2;16;16;0;1;1;1;1;1;1;1;1;1;1;2;16;16;16;16;16;0;1;1;1;1;1;1;1;1;1;1;1;2;16;16;16;16;16;16;0;1;1;1;1;1;1;1;1;1;1;1;1;1;1;1;1;1;1;2;16;16;16;16;16;12;13;13;13;13;13;14;16;16;16;8;10;16;16;16;16;16;16;16;16;16;16;12;13;13;13;13;13;13;13;13;14;8;10;12;13;13;13;13;13;13;13;13;13;14;16;16;16;12;13;13;13;13;13;14;16;16;16;16;16;16;16;16;16;16;12;13;13;13;13;13;14;16;16;16;16;16;16;16;16;16;16;16;16;16;16;16;4;6;16;16;16;12;13;13;13;13;13;13;13;13;13;13;14
20;20;20;20;20;20;20;20;20;20;20;20;20;20;20;20;20;20;20;20;20;20;20;20;20;20;20;20;20;20;20;20;20;20;20;20;20;20;20;20;20;20;20;20;20;20;20;20;20;20;20;20;20;20;20;20;20;20;20;20;20;20;20;20;20;20;20;20;20;20;20;20;20;20;20;20;20;20;20;20;20;20;20;20;20;20;20;20;20;20;20;20;20;20;20;20;20;20;20;20;20;20;20;20;20;20;20;20;20;20;20;20;20;20;20;20;20;20;20;20;20;20;20;20;20;20;20;20;20;20;20;20;20;20;20;20;20;20;20;20;20;20;20;20;20;20;20;20;20;20;20;20;20;20;20;20;20;20;20;20;20;20;20;20;20;20;20;20;20;20;20;20;20;20;20;20;20;20;20;20;20;20;20;20;20;20;20;20;20;20;20;20;20;20;20;20;20;20;20;20;20;20;20;20;20;20;20;20;20;20;20;20;20
